10000000000001
10000000000001
10000000000001
10000100010001
10020100010201
10020100010201
10020100010201
10020100010201
10000100010001
10000000000001
10000000000001
10000000000001
10000000000001
